+---+---+---+---+---+---+---+---+---+---+
                                        |
+   +---+   +---+---+   +---+---+---+   +
|   |   |   |   |   |   |   |   |   |   |
+   +   +   +---+   +   +   +---+---+   +
|   |   |   |   |   |   |   |   |       |
+   +   +---+   +   +   +---+   +---+   +
|   |   |   |   |       |   |   |   |   |
+   +   +---+   +   +   +---+   +   +---+
|   |       |       |   |   |   |       |
+   +---+---+---+   +---+   +   +---+   +
|   |   |   |   |   |   |   |       |   |
+   +---+---+   +   +---+   +   +   +---+
|       |       |               |   |   |
+   +---+---+   +---+---+---+   +   +   +
|   |   |   |   |   |   |       |       |
+   +   +---+   +---+---+---+   +---+   +
|   |       |       |   |   |   |   |   |
+   +---+   +---+---+---+---+---+   +   +
|                                        
+---+---+---+---+---+---+---+---+---+---+
