+---+---+---+---+---+---+---+---+---+---+
                                        |
+   +---+   +---+---+   +---+---+---+   +
|   |   |   |   |   |   |   |   |   |   |
+   +   +   +---+   +   +   +---+---+   +
|   |       |   |   |   |   |   |       |
+   +   +---+   +   +   +---+   +---+   +
|   |   |   |           |   |   |   |   |
+   +   +---+   +---+   +---+   +   +---+
|           |       |   |   |   |       |
+   +---+---+---+   +---+   +---+   +   +
|   |   |   |   |   |   |   |   |   |   |
+---+---+---+   +   +---+   +   +   +---+
|       |       |       |       |   |   |
+   +---+---+   +   +---+---+   +   +   +
|   |   |   |       |   |       |       |
+   +   +---+   +---+---+---+   +---+   +
|               |   |   |           |   |
+   +---+---+---+---+---+   +---+   +   +
|                               |       
+---+---+---+---+---+---+---+---+---+---+
